#,#,#,#,#,#,#,#,#
#,.,.,.,.|+,.,.,/1Dungeon 2,#
#,.,.,.,.,.,.|Z,.,#
#,.,.,.,.,.,.,.,#
#,.,.,.,.,.,.,.,#
#,#,.,.,.,#,.,.,#
#,#,.,.|:,#,#,w,.,#
#,#,.,.,#,#,w,w,#
#,#,#,.,#,/0Swamp,w,.,#
#,.,.,.,#,w,w,.,#
#,.,#,.,#,w,.,.,#
#,.,#,.,#,.,.,.,#
#,.,#,#,#,.|Z,.|g,.|Z,#
#,.,#,#,#,#,.|Z,#,#
#,#,#,#,#,#,#,#,#