#,#,#,#,#,#,#,#,#,#,#,#,#
#,/1Dungeon 4, .,., .,#,#, ., ., ., ., .,#
#, ., .,.|X, .,#, ., ., .|Z, ., ., .,#
#,.|X,.|Z, ., .,#, ., ., ., ., ., .,#
#, .,.|Z, .,.|X,#,#,#, ., ., ., .,#
#,#,#,#, .,#,#, ., ., ., ., .,#
#, ., ., ., ., ., ., ., ., ., ., .,#
#,., .,#, .,#,#, ., ., ., ., .,#
#,#, .,.,#,#,#,#, ., ., ., .,#
#,#, .,#,#,#,#,#, ., ., ., .,#
#,#, ., .,#,#,/0Dungeon 2, ., ., ., ., .,#
#, ., .,#,#,.,#, ., ., ., ., .,#
#,.,., .,.,#,#,#, ., ., ., .,#
#,#,., .,.,.|Z,.,#,#, ., .,#,#
#,#,#,#,#,#,#,#,#,#,#,.,#