#,#,#,#,#,#,#,#,#,#,#,#,#
#,#, ., ., .,#,#, ., ., ., ., .,#
#, ., ., ., ., ., ., ., .|Z, ., ., .,#
#, ., ., ., ., ., ., ., ., ., ., .,#
#, ., ., ., ., ., ., ., ., ., .,w,#
#, ., ., ., .,#,#, ., ., .,w,w,#
#, ., ., ., .,#,#, ., .,w,w,w,#
#,#, .,#, .,#,#, ., .,w,w,w|Z,#
#,#, .,#,#,#,#,#, ., .,w,w,#
#,#, .,#,#,#,#,#, ., ., ., .,#
#,#, ., .,#,#,/0Dungeon 3, ., ., ., ., .,#
#, ., .,#,#,#,#, ., ., ., ., .,#
#,#,., .,.,#,#,#, ., ., ., .,#
#, .,#, .,.,.|Z,.|Z,#,#, ., ., .,#
#,/1Dungeon 1,#,#,#,#,#,#,#, ., ., .,#