#,#,#,#,#,#,#,#,#,#,#,#,#,#,#,#,#,#,#,#,#,#,#,#,#,#,#,#,#,#
#,#,#, ., .,#,#, ., ., .,#,#,#,#, ., .,w,w,w,w,w,w,w, ., ., .,#, ., .,#
#,#, ., ., ., .,#, ., .|Z, ., .,#,#, ., .,w,w,w,w,w|Z,w,w,w,w, ., ., ., ., .,#
#, ., ., ., ., .,#, ., ., ., ., .,#,#, .,w,w,w,w,w,w,w|Z,w,w, .,#,#,#, .,#
#, ., ., ., ., ., ., ., ., ., .,w,#, ., .,w,w,w,w,w,w,w,w,w, .,#, .,#, .,#
#, ., .|Z,., .,#,#, ., ., .,w,w,w, ., ., .,w,w,w,w,w,w,w,., .,#, ., ., .,#
#, .|Z,.|X, .|Z, .,#,#, ., .,w,w,w,#,#,#,#,#,#,#,#, ., ., ., ., .,#,#,#,#,#
#,#, .|Z,#, .|Z,#,.|X, ., .|Z,w,w,w|Z,#, ., ., ., ., ., ., ., .|X, ., ., ., .,#, ., ., .,#
#,#, .|Z,#,#, .|Z,#,#, ., .|Z,w,w,#, .,#,#,.,#, .,#,#,#,#,#,#,#, .,#, .,#
#,#, .,#, .|Z,#,#,#, ., ., ., .,#, .,#, ., ., ., .,#, ., ., ., ., ., ., .,#, .,#
#,#, ., .,#,#,/0Dungeon 3, ., ., ., ., .,#, .,#, .,#,#,#,#, .,#,#,#,#,#,#,#,#,#
#, ., .,#,#,#,#, ., ., ., ., .,#, .,#, .,#, ., ., ., .,#, ., .,.|X, .|Z, .|Z, ., .,#
#,#,., .,.,#,#,#, ., .,#, .,#, .,#, .,#, .,#,#, .,#,#,#,#,#,#, ., .,#
#, .,#, .,.,.|Z,.|X,#,#, .,#, .,., .,#, ., ., .,#, ., ., ., ., ., ., ., ., ., .,#
#,/1Dungeon 1,#,#,#,#,#,#,#,#,#,#,#,#,#,#,#,#,#,#,#,#,#,#,#,#,#, ., .,#
#, ., ., ., ., .,#, .,#, ., ., .,.|Z, ., .,#, ., ., ., ., ., .,#,.|Z, .,#, .|X, ., .,#
#,#,#,#,#, .,#, ., ., ., .,.|Z, .|X,#, .,#, ., ., ., ., ., .,#, .,.|Z,#, ., ., .,#
#, ., ., ., ., .,#, .,#,#,#,#,.,#, .,#, ., .,w,.,w,w,w,w,w,w,w,w,w,#
#, .,#, .,#, .,#, ., ., ., ., ., .,#, .,#, .,w,w,w,w,w,w,w,w,w,w,w,w,#
#, .,#, .,#, .,#,#,#,#,#, ., .,#, .,#, .,w,w,w,w,w,w,w,w,w,w,.,w,#
#,w,#, .,#,.|Z, ., ., ., ., .,., .,#, .,#, ., .,w,w,w,w,w,w,w,w,.|Z,.,w,#
#, .,#,#,#, .,#,#,.,#,#, ., .,#, .,#, ., ., ., ., ., ., ., ., ., ., ., ., .,#
#, ., ., ., .,.|Z, ., ., ., ., ., ., .,#, ., ., .|X, ., ., ., ., ., ., ., ., ., ., ., .,#
#,#,#,#,#,#,#,#,#,#,#,#,#,#,#,#,#,#,#,#,#,#,#,#,#,#,#,#,#,#