#,#,#,#,#,#,#,#,#,#,#,#,#,#,#,#,#,#,#,#,#,#,#,#,#,#,#,#,#,#
#,#,#, .|g, .|g,#,#, ., ., .,#,#,#,#, ., .,w,w,w,w,w,w,w, ., .|g, .|g,#, ., .,#
#,#, .|g, .|g, .|g, .,#, ., .|Z, ., .,#,#, ., .,w,w,w,w,w|Z,w,w,w,w, ., ., ., ., .,#
#, ., ., ., ., .,#, ., ., ., ., .,#,#, .,w,w,w,w,w,w,w|Z,w,w, .,#,#,#, .,#
#, ., ., ., ., ., ., ., ., ., .,w,#, ., .,w,w,w,w,w,w,w,w,w, .,#, .,#, .,#
#, ., .|Z,., .,#,#, ., ., .,w,w,w, ., ., .,w,w,w,w,w,w,w,., .,#, ., ., .,#
#, .|Z,.|X, .|Z, .,#,#, ., .,w,w,w,#,#,#,#,#,#,#,#, ., ., ., ., .,#,#,#,#,#
#,#, .|Z,#, .|Z,#,.|X, ., .|Z,w,w,w|Z,#, ., ., ., ., ., ., ., .|X, ., ., ., .,#, ., ., .,#
#,#, .|Z,#,#, .|Z,#,#, ., .|Z,w,w,#, .,#,#,.,#, .,#,#,#,#,#,#,#, .,#, .,#
#,#, w,#, w|Z,#,#,#, ., ., ., .,#, .,#, ., ., ., .,#, ., ., ., ., ., ., .,#, .,#
#,#, ., w,#,#,/0Dungeon 3, ., ., ., ., .,#, .,#, .,#,#,#,#, .,#,#,#,#,#,#,#,#,#
#, ., .,#,#,#,#, ., ., ., ., .,#, .,#, .,#, ., ., ., .,#, ., .,.|X, .|Z, .|Z, ., .,#
#,#,., .|:,.|:,#,#,#, ., .,#, .,#, .,#, .,#, .,#,#, .,#,#,#,#,#,#, ., .,#
#, .,#, .|:,.|:,.|Z,.|X,#,#, .,#, .,., .,#, ., ., .,#, ., ., ., ., ., ., ., ., ., .,#
#,/1Dungeon 1,#,#,#,#,#,#,#,#,#,#,#,#,#,#,#,#,#,#,#,#,#,#,#,#,#, ., .,#
#, ., .|:, .|:, .|:, .|Z,#, .,#, ., ., .,.|Z, ., .,#, ., ., ., ., ., .,#,.|Z, .,#, .|X, ., .,#
#,#,#,#,#, .,#, ., ., ., .,.|Z, .|X,#, .,#, ., ., ., ., ., .,#, .,.|Z,#, ., ., .,#
#, ., ., ., ., .,#, .,#,#,#,#,.,#, .,#, ., .,w,.,w,w,w,w,w,w,w,w,w,#
#, .,#, .,#, .,#, ., ., ., ., ., .,#, .,#, .,w,w,w,w,w,w,w,w,w,w,w,w,#
#, .,#, .,#, .,#,#,#,#,#, ., .,#, .,#, .,w,w,w,w,w,w,w,w,w,w,.,w,#
#,w,#, .,#,.|Z, ., ., ., ., .,., .,#, .,#, ., .,w,w,w,w,w,w,w,w,.|Z,.,w,#
#, .,#,#,#, .,#,#,.,#,#, ., .,#, .,#, ., ., ., ., ., ., ., ., ., ., ., ., .,#
#, .|+, ., ., .,.|Z, ., ., ., ., ., ., .,#, ., ., .|X, ., ., ., ., ., ., ., ., ., ., ., .,#
#,#,#,#,#,#,#,#,#,#,#,#,#,#,#,#,#,#,#,#,#,#,#,#,#,#,#,#,#,#