#,#,#,#,#,#,#,#,#,#,#,#,#
#,/1Dungeon 4, .,., .,#,#, ., ., ., ., .,#
#, ., .,.|Z, .,#, ., ., .|Z, ., ., .,#
#,.|Z,.|Z, ., .,#, ., ., ., ., ., .,#
#, .,.|Z, .,.|Z,#,#,#, ., ., ., .,#
#,#,#,#, .,#,#, ., ., ., ., .,#
#, ., ., ., ., ., ., ., ., ., ., .,#
#,., .,#, .,#,#, ., ., ., ., .,#
#,#, .,.,#,#,#,#, ., ., ., .,#
#,#, .,#,#,#,#,#, ., ., ., .,#
#,#, ., .,#,#,/0Dungeon 2, ., ., ., ., .,#
#, ., .,#,#,.,#, ., ., ., ., .,#
#,.,., .,.,#,#,#, ., ., ., .,#
#,#,., .,.,.|Z,.,#,#, ., .,#,#
#,#,#,#,#,#,#,#,#,#,#,.,#