#,/2Swamp, .,w,w, ., ., ., .|M,#,#,#,#,#,#,#,#,#
#, .,#,#,#,w,w,w,w,w,w,w,w,#,.,#, .,#
#, .,#, .,#,w,#,#,#,#,#, .,#,#,.,#, .,#
#, ., ., .,#,w, ., ., ., .,#, .,#,.,#,#, ., .
#, ., .,#,#,w,#,#,#,.,#, ., .,#,.,., .,#
#,w, .,w,#,w,w,#,w,.,#, .,#,#,#,#, .,#
#, ., .,w,#,w,#,#,#,#,#, .,#,.,w,#, ., .
#, .,#,#,#,w,w,w, .,#, ., ., .,.,w,#,#, .
#, ., .,.,#,#,#,., .,#,#,#, .,#,w,#, ., .
#, .,#,w,w,w, .,.,#,#, ., ., .,.,w,#, .,#
#, .,#,w,#,#, .,#,#,#, .,#, .,#,w,#, .,.
#, .,#,w,#,#,w, .,.,#,., ., .,#,w,#,#,#
#, ., .,.,.,.,#, .,.,#,.,#, .,.,w,#, .,#
#,#, .,w,#,#,#,w,w,.,., .,w,w,w,#, .,#
#,#, .,w,w,w, .,#,#,#,w,w,#,#,#,#, .,#
#, ., .,., .,., ., .,., .,., .,#, ., ., ., .,#
#, .,#,#,#,.,#,#,#, .,#,#,#, .,#,#, .,#
#, .,#,., .,.,#, .,#, .,., ., ., ., .,#, .,#
#, ., .,.,#,., ., .,., .,w, .,#,#,#,#,#,#